1111111
1010001
1010001
1010001
1010001
1000101
100N001
1111111