11111111
10100001
10100001
10100001
10100001
10000101
1000N001
11111111