NO ./assets/img/bricks.xpm
SO ./assets/img/bricks2.xpm
WE ./assets/img/bookshelf.xpm
EA ./assets/img/dirt.xpm

F 120,25,80
C 0,255,0

11111111111111111111111111
10000000000000000000000001
10000000000000000000000001
10000000000000000000000001
10000000000000000000000001
10000000000000000000000001
1S000000000000000000000001
11111111111111111111111111