NO ./assets/img/bricks.xpm
SO ./assets/img/bricks2.xpm
WE ./assets/img/bookshelf.xpm
EA ./assets/img/dirt.xpm

F 220,100,0
C 225,30,0

11111111
10000001
10111001
10001001
11111001
10000001
1000E001
11111111